6 8 16
2 0 0 3 0 2
0 0 2 0 1 0
2 0 0 0 0 0
0 0 0 1 0 2
4 0 8 0 3 0
0 0 0 1 0 0
0 0 2 0 0 1
2 0 0 2 0 0