6 8 18
0 2 0 0 2 0
1 0 0 2 0 2
0 2 0 0 1 0
3 0 0 0 0 0
0 4 0 8 0 5
4 0 1 0 0 0
0 1 0 2 0 0
3 0 3 0 0 2