6 8 18
0 2 0 0 2 0
0 0 0 0 0 1
2 0 1 0 3 0
0 1 0 0 0 2
5 0 6 0 6 0
0 0 0 2 0 2
0 0 1 0 2 0
3 0 0 6 0 3