7 9 23
2 0 2 0 0 2 0
0 2 0 0 3 0 1
5 0 0 2 0 0 0
0 0 0 0 0 2 0
6 0 4 0 3 0 2
0 1 0 0 0 1 0
3 0 1 0 0 0 0
0 3 0 0 4 0 2
2 0 2 0 0 1 0