7 7 2
2 0 0 5 0 3 0
0 0 0 0 0 0 1
4 0 0 6 0 2 0
0 0 0 0 0 0 0
0 1 0 3 0 0 3
2 0 2 0 0 1 0
0 2 0 0 3 0 2