7 7 17
2 0 3 0 6 0 2
0 0 0 0 0 0 0
0 2 0 0 8 0 3
0 0 0 0 0 0 0
2 0 0 2 0 0 1
0 0 0 0 2 0 0
0 2 0 5 0 0 2