7 7 19
2 0 3 0 6 0 2
0 2 0 1 0 0 0
2 0 0 0 0 0 0
0 3 0 0 6 0 3
3 0 2 0 0 1 0
0 1 0 2 0 0 2
2 0 2 0 0 1 0