7 7 19
0 1 0 4 0 0 3
3 0 1 0 0 0 0
0 2 0 6 0 1 0
0 0 0 0 2 0 6
4 0 0 3 0 1 0
0 0 2 0 3 0 3
2 0 0 3 0 2 0