8 10 29
2 0 4 0 3 0 2 0
0 0 0 2 0 6 0 3
4 0 7 0 3 0 1 0
0 0 0 1 0 2 0 3
3 0 0 0 4 0 2 0
0 0 2 0 0 0 0 0
0 0 0 2 0 2 0 6
4 0 0 0 3 0 1 0
0 0 1 0 0 0 0 0
3 0 0 3 0 2 0 3