8 10 33
1 0 2 0 5 0 1 0
0 0 0 0 0 1 0 2
4 0 5 0 8 0 2 0
0 0 0 0 0 2 0 4
3 0 4 0 8 0 4 0
0 0 0 1 0 1 0 2
0 0 1 0 3 0 3 0
4 0 0 2 0 2 0 2
0 0 2 0 3 0 1 0
2 0 0 2 0 3 0 2