7 9 23
2 0 3 0 4 0 2
0 0 0 0 0 0 0
4 0 0 5 0 3 0
0 0 0 0 0 0 1
5 0 3 0 0 1 0
0 2 0 4 0 0 5
2 0 2 0 0 1 0
0 4 0 0 4 0 4
2 0 0 3 0 2 0