6 8 18
3 0 6 0 3 0
0 0 0 0 0 2
3 0 0 2 0 0
0 0 2 0 1 0
5 0 0 7 0 5
0 0 0 0 2 0
0 1 0 2 0 1
2 0 2 0 3 0