7 9 22
0 3 0 0 6 0 2
0 0 2 0 0 0 0
1 0 0 0 4 0 2
0 1 0 0 0 2 0
3 0 7 0 4 0 0
0 0 0 1 0 0 3
2 0 0 0 0 3 0
0 0 2 0 1 0 2
2 0 0 3 0 2 0