6 8 16
0 1 0 0 3 0
3 0 0 1 0 2
0 0 2 0 6 0
0 0 0 0 0 3
6 0 5 0 5 0
0 0 0 0 0 2
0 0 0 0 1 0
2 0 2 0 0 2