7 7 17
2 0 0 3 0 2 0
0 0 2 0 6 0 3
3 0 0 1 0 1 0
0 0 0 0 0 0 2
5 0 4 0 3 0 0
0 0 0 0 0 0 1
2 0 2 0 0 2 0