7 10 28
2 0 4 0 2 0 0
0 0 0 1 0 0 2
6 0 7 0 0 3 0
0 1 0 0 0 0 2
3 0 4 0 2 0 0
0 2 0 2 0 3 0
4 0 3 0 3 0 4
0 0 0 2 0 3 0
0 0 2 0 1 0 1
3 0 0 3 0 3 0