8 11 33
3 0 6 0 3 0 2 0
0 0 0 1 0 2 0 1
2 0 0 0 2 0 1 0
0 0 2 0 0 2 0 3
5 0 0 0 8 0 3 0
0 3 0 3 0 0 0 2
3 0 0 0 0 0 1 0
0 3 0 0 5 0 0 4
3 0 0 2 0 0 0 0
0 3 0 0 5 0 2 0
3 0 3 0 0 2 0 1