8 11 35
1 0 4 0 2 0 0 3
0 0 0 1 0 0 3 0
4 0 7 0 2 0 0 3
0 2 0 0 0 0 3 0
3 0 0 1 0 0 0 3
0 0 2 0 4 0 2 0
0 5 0 2 0 1 0 4
3 0 2 0 5 0 1 0
0 4 0 2 0 5 0 3
2 0 0 0 0 0 0 0
0 1 0 2 0 6 0 2