10 14 32
2 0 4 0 4 0 2 0 1 0
0 0 0 2 0 1 0 0 0 3
0 0 2 0 4 0 0 3 0 0
4 0 0 3 0 0 0 0 1 0
0 0 0 0 0 2 0 6 0 4
4 0 0 2 0 0 0 0 3 0
0 0 0 0 0 1 0 3 0 4
4 0 4 0 5 0 3 0 3 0
0 0 0 3 0 4 0 5 0 5
2 0 3 0 2 0 0 0 1 0
0 1 0 0 0 0 0 2 0 3
1 0 0 4 0 8 0 0 3 0
0 0 1 0 0 0 0 0 0 0
0 2 0 3 0 4 0 2 0 3