8 11 32
4 0 0 3 0 0 1 0
0 3 0 0 5 0 0 2
3 0 0 0 0 0 1 0
0 2 0 1 0 0 0 3
5 0 4 0 7 0 2 0
0 3 0 1 0 4 0 5
4 0 0 0 0 0 2 0
0 0 1 0 4 0 0 2
3 0 0 0 0 2 0 0
0 3 0 0 2 0 0 1
3 0 4 0 0 0 4 0