7 10 27
3 0 3 0 3 0 3
0 0 0 0 0 0 0
0 0 4 0 8 0 4
6 0 0 2 0 0 0
0 0 3 0 5 0 3
0 1 0 2 0 1 0
3 0 2 0 4 0 5
0 3 0 5 0 2 0
0 0 0 0 2 0 2
3 0 0 5 0 3 0