8 11 33
2 0 6 0 2 0 1 0
0 0 0 0 0 0 0 1
2 0 6 0 4 0 3 0
0 0 0 1 0 1 0 2
0 0 2 0 3 0 1 0
3 0 0 3 0 0 0 0
0 0 0 0 0 3 0 4
4 0 1 0 4 0 2 0
0 0 0 1 0 2 0 4
0 1 0 0 3 0 1 0
3 0 2 0 0 3 0 3