5 5 10
0 1 0 0 2
2 0 0 2 0
0 0 2 0 2
0 0 0 1 0
3 0 6 0 3