6 6 12
0 2 0 6 0 2
3 0 2 0 0 0
0 1 0 7 0 3
0 0 0 0 0 0
2 0 0 3 0 0
0 0 1 0 0 2