6 8 18
1 0 2 0 0 2
0 0 0 0 0 0
4 0 7 0 1 0
0 0 0 3 0 6
2 0 3 0 2 0
0 0 0 1 0 3
0 0 2 0 3 0
2 0 0 2 0 2