5 5 9
2 0 0 2 0
0 0 2 0 1
2 0 0 0 0
0 0 0 1 0
3 0 6 0 3