6 6 13
2 0 1 0 2 0
0 0 0 0 0 2
5 0 5 0 6 0
0 0 0 0 0 3
0 1 0 0 3 0
3 0 4 0 0 3