6 8 17
2 0 0 3 0 0
0 1 0 0 0 1
2 0 0 0 0 0
0 4 0 8 0 4
2 0 1 0 0 0
0 2 0 2 0 0
1 0 2 0 0 2
0 2 0 0 1 0