6 6 14
2 0 0 2 0 3
0 0 3 0 1 0
2 0 0 0 0 0
0 0 0 2 0 6
3 0 6 0 2 0
0 1 0 2 0 3