5 7 12
0 1 0 0 3
2 0 2 0 0
0 0 0 0 0
0 0 3 0 6
3 0 0 1 0
0 1 0 0 3
2 0 1 0 0