5 7 13
3 0 6 0 3
0 1 0 0 0
2 0 2 0 0
0 2 0 0 3
5 0 3 0 0
0 0 0 0 1
2 0 1 0 0