6 8 20
3 0 4 0 3 0
0 1 0 2 0 1
0 0 0 0 3 0
3 0 0 2 0 2
0 3 0 0 6 0
2 0 1 0 0 2
0 1 0 0 2 0
2 0 3 0 0 2