5 5 9
0 2 0 0 2
1 0 0 0 0
0 0 3 0 2
0 1 0 0 0
3 0 6 0 2