5 7 13
2 0 2 0 2
0 3 0 3 0
2 0 0 0 0
0 2 0 0 2
3 0 0 6 0
0 0 0 0 1
0 1 0 3 0