5 7 12
0 1 0 0 3
3 0 0 1 0
0 2 0 0 5
0 0 0 0 0
6 0 5 0 5
0 0 0 0 0
2 0 1 0 2