7 9 22
2 0 2 0 1 0 0
0 2 0 5 0 0 2
4 0 1 0 0 2 0
0 0 0 0 0 0 2
5 0 0 8 0 5 0
0 1 0 0 2 0 0
1 0 0 2 0 0 2
0 0 0 0 0 1 0
0 3 0 0 6 0 3