7 7 18
1 0 3 0 0 3 0
0 0 0 0 0 0 0
4 0 8 0 2 0 1
0 1 0 2 0 6 0
1 0 3 0 2 0 2
0 0 0 0 0 2 0
0 2 0 0 3 0 2