7 9 25
2 0 4 0 2 0 1
0 0 0 3 0 1 0
0 0 1 0 1 0 3
4 0 0 8 0 2 0
0 1 0 0 2 0 4
2 0 0 0 0 0 0
0 2 0 4 0 0 3
2 0 2 0 0 1 0
0 1 0 2 0 0 2