6 6 14
1 0 3 0 0 3
0 0 0 0 0 0
3 0 8 0 2 0
0 0 0 2 0 6
1 0 4 0 1 0
0 1 0 2 0 3