5 5 9
3 0 0 2 0
0 0 0 0 1
6 0 3 0 0
0 0 0 1 0
2 0 2 0 2