6 6 12
0 2 0 0 2 0
2 0 2 0 0 0
0 1 0 0 0 2
5 0 8 0 3 0
0 0 0 0 0 0
1 0 3 0 0 3