6 8 19
0 0 2 0 0 2
2 0 0 0 0 0
0 0 3 0 2 0
0 0 0 1 0 3
5 0 5 0 1 0
0 1 0 3 0 6
1 0 4 0 2 0
0 2 0 2 0 3